
DFS:
+---+---+---+---+
| 1 | 6   7 |   |
+   +   +   +   +
| 2 | 5 | 8   9 |
+   +   +---+   +
| 3   4 |   | 0 |
+---+---+   +   +
|             1 |
+---+---+---+---+
+---+---+---+---+
| # | #   # |   |
+   +   +   +   +
| # | # | #   # |
+   +   +---+   +
| #   # |   | # |
+---+---+   +   +
|             # |
+---+---+---+---+
Path: 
[0, 4, 8, 9, 5, 1, 2, 6, 7, 11, 15]
Length of path: 11
Visited cells: 11
