
BFS:
+---+---+---+---+
| 0 | 5   6 | 0 |
+   +   +   +   +
| 1 | 4 | 7   8 |
+   +   +---+   +
| 2   3 |   | 9 |
+---+---+   +   +
|             1 |
+---+---+---+---+
+---+---+---+---+
| # | #   # |   |
+   +   +   +   +
| # | # | #   # |
+   +   +---+   +
| #   # |   | # |
+---+---+   +   +
|             # |
+---+---+---+---+
Path: 
[0, 4, 8, 9, 5, 1, 2, 6, 7, 11, 15]
Length of path: 11
Visited cells: 12